|EN|EN|VT|EN|EN|
|EN|  |NA|  |EN|
|EN|NA|EN|  |NA|
|NA|  |ST|EN|EN|
|NA|  |EN|  |NA|
