|EN|EN|VT|EN|EN|
|EN|  |TT|  |EN|
|EN|NA|FG|  |NA|
|NA|  |ST|EN|EN|
|NA|  |EN|  |NA|
